R			100 100
NO		    ./textures/white.jpg
SO			 ./textures/black.jpg
WE		  ./textures/blue.jpg
EA		  ./textures/red.jpg
S		  ./sprites/terro.jpg
F	 0 ,  255 ,  255
C   	0  ,		255	,  255

11111111111111111111111111111
10000100000000000000000000001
10000000000N00000000000000001
10000100000000000000000000001
11111111111111111111111111111
