R			400 400
NO		    ./textures/white.jpg
SO			 ./textures/black.jpg
WE		  ./textures/blue.jpg
EA		  ./textures/red.jpg
S		  ./sprites/terro.jpg
F	 0 ,  255 ,  255
C   	0  ,		255	,  255

11111111111111111111111111111
10000000000000000000000000001
10000000000000000000000000001
10000000000000000000000000001
11111111111111111111111111111
