R			1280 720
NO		    ./textures/white.jpg
SO			 ./textures/black.jpg
EA		  ./textures/blue.jpg
WE		  ./textures/red.jpg
S		  ./sprites/terro.jpg
C   	0  ,		0	,  255
F	 255 ,  0 ,  0

11111111
10001001
10000001
1000N001
10000001
11100001
10000001
11111111
