R			800 600
NO		    ./textures/white.jpg
SO			 ./textures/black.jpg
EA		  ./textures/blue.jpg
WE		  ./textures/red.jpg
S		  ./sprites/terro.jpg
F	 0 ,  255 ,  255
C   	0  ,		255	,  255

1111111111111111
1000000010000001
10N0000000000011
1000000010000001
1111111111111111
